class	smiles	name
ACETYL-COA	C	acetyl-CoA
CO	C	
CO2	O	CO2
CO3	O	hydrogencarbonate
CoA	C	CoA
H+	[	
H2O2	O	H2O2
HBr	B	
HCN	C	hydrogen cyanide
HCl	C	
HF	F	
HI	I	
NH3	N	NH4(+)
O2	O	O2
PPI	O	diphosphate
Pi	O	phosphate
SULFATE	O	sulfate
SULFITE	O	sulfite
WATER	O	H2O
